111111111
10P000001
1C11110E1
100000001
111111111