111111111111111111111111111111111111
111111111111111110111111111111111111
100000000000000000000E00000P00000001
1000000000C0000000000000000000000001
111111111111111111111111111111111111