111111111111111111111111111111111111
111111111111111110111111111111111111
100000000010000000000E00000000000001
1000000001C1000000000000000000000P01
111111111111111111111111111111111111