1111111111111111111111111P1111111111
111111111111111110111111111111111111
100000000000000000000E00000000000001
1000000000C0000000000000000000000001
111111111111111111111111111111111111